01,01,01,01,01,01,01,01,01,01,01,01,01
01,01,01,01,01,01,01,01,01,01,01,01,01
01,01,01,01,01,01,01,01,11,01,01,01,11
01,01,01,01,01,01,01,01,11,01,01,01,00
10,01,01,01,01,01,11,11,01,01,00,01,01
10,01,01,01,01,01,11,11,11,01,00,01,11
10,01,01,01,01,01,11,11,01,01,00,01,11
01,01,01,01,01,01,01,11,01,11,11,01,11
01,01,01,01,01,01,01,11,10,11,00,11,01
01,01,01,01,01,01,01,11,11,11,11,11,11
01,01,01,01,01,01,01,01,00,00,00,01,00
01,01,01,01,01,01,01,01,01,00,01,00,00
01,01,01,01,00,01,01,01,01,01,01,01,00
01,01,01,01,00,00,01,01,01,01,01,01,01
01,01,01,01,10,10,10,01,01,01,00,00,01

0,0,0,0,0,0,0,0,0,0,0,0,0
0,0,0,0,0,0,0,0,0,0,0,0,0
0,0,0,0,0,0,0,0,0,0,0,0,0
0,0,0,0,0,0,0,0,0,0,0,0,0
1,0,0,0,0,0,0,0,0,0,0,0,0
1,0,0,0,0,0,0,0,0,0,0,0,0
1,0,0,0,0,0,0,0,0,0,0,0,0
0,0,0,0,0,0,0,0,0,0,0,0,0
0,0,0,0,0,0,0,0,1,0,0,0,0
0,0,0,0,0,0,0,0,0,0,0,0,0
0,0,0,0,0,0,0,0,0,0,0,0,0
0,0,0,0,0,0,0,0,0,0,0,0,0
0,0,0,0,0,0,0,0,0,0,0,0,0
0,0,0,0,0,0,0,0,0,0,0,0,0
0,0,0,0,1,1,1,0,0,0,0,0,0